###########
#P...E....#
#.#.#.###.#
#.#.#...#.#
#.#.###.#.#
#...#T#...#
###.#.#.####
#...#.#...#
#.###.#.#.#
#.....I...#
########X##