###########
#P...I....#
#.#.#.###.#
#.#.#...#.#
#.#.###.#.#
#...#T#...#
###.#.#.###
#...#.#...#
#.###.#.#.#
#.....E...#
########X##